{
	"tileset" : "ressources/terrain.png",
	"terrain" : [
		[162, 162, 162, 162, 162, 162, 162, 162, 171,  171,  171,  171,  171,  171,  171,171 ],
		[162, 162, 162, 162, 162, 162, 162, 162, 171,  171,  171,  171,  171,  171,  171,171],
		[162, 162, 162, 162, 162, 162, 162, 162, 171,  171,  171,  171,  171,  171,  171,171],
		[162, 162, 162, 162, 162, 162, 162, 162, 171,  171,  171,  171,  171,  171,  171,171],
		[162, 162, 162, 162, 162, 162, 162, 162, 171,  171,  171,  171,  171,  171,  171,171],
		[162, 162, 162, 162, 162, 162, 162, 162, 171,  171,  171,  171,  171,  171,  171,171],
		[162, 162, 162, 162, 162, 162, 162, 162, 171,  171,  171,  171,  171,  171,  171,171],
		[162, 162, 162, 162, 162, 162, 162, 162, 171,  171,  171,  171, 171, 171, 171,171],
		[353, 353, 353, 353, 353, 353, 353, 353, 246, 246, 246, 246, 246, 246, 246,246],
		[353, 353, 353, 353, 353, 353, 353, 353, 246,  246,  246,  246,  246,  246,  246,246],
		[353, 353, 353, 353, 353, 353, 353, 353, 246,  246,  246,  246,  246,  246,  246,246],
		[353, 353, 353, 353, 353, 353, 353, 353, 246,  246,  246,  246,  246,  246,  246,246],
		[353, 353, 353, 353, 353, 353, 353, 353, 246,  246,  246,  246,  246,  246,  246,246],
		[353, 353, 353, 353, 353, 353, 353, 353, 246,  246,  246,  246,  246,  246,  246,246],
		[353, 353, 353, 353, 353, 353, 353, 353, 246,  246,  246,  246,  246,  246,  246,246],
		[353, 353, 353, 353, 353, 353, 353, 353, 246,  246,  246,  246,  246,  246,  246,246]
	]
}